1111111111111111111111111
1011111310101100033333331
1030000000000131011111131
1311113113111101010000001
1000000000000003030000001
1131131113111111014000001
1101100000000211014400001
1111111111111111011111111
2222222222222222322222222
2200022220000000000220002
2232002200222222000000202
2202000000200002220002002
2222222222222222222222222