11111111111111111111111111111111111111
10100000000011111111111111001111100111
10101111110011111111111110000111000011
13101000000000111111111100000020000001
10001011110011111111111111000000000011
11131311110000111111111111100000000111
10001000100000111111111111110000001111
10001111100111111111111111111101111111
10000300000000000000030000000000011111
11111111111111111111111111111111111111